11 11
MMMMMMMMMMM
M.........M
M.........M
M.........M
MC.......AM
MA...P...CM
M.........M
M.........M
M.........M
M....CA...M
MMMMMMMMMMM
