9 10
..........
..MMMMMM..
..M....MM.
.MMAMMC.M.
.M.AAC..M.
.M..MC..M.
.M.P..MMM.
.MMMMMM...
..........
