11 11
MMMMMMMMMMM
M.........M
MMMMMMMMM.M
M.........M
MMMMM.MMMMM
MA..M.....M
MC..MM....M
M...MM....M
M.........M
M...P.....M
MMMMMMMMMMM
